###########
#    #  # #
#    #  # #
#    #  # #
#       # #
#       # #
#         #
#         #
#     #####
#         #
###########
